NO ./path_to_the_north_texture
SO ./path_to_the_south_texture
WE ./path_to_the_west_texture

F 23,100,210






EA ./path_to_the_east_texture
C 125,12,10




        11111111111111111111111111
        1000000000110000000000001
        1011000001110000000000001
        1001000000000000000000001
111111111011000001110000000000001
1000000000110000011101111111111111
11110111111110111000000100001
11110111111111011101010010001
11000000110101011100000010N001
10000000000000001100000010001
10000000000000001110100100001
1100000111010101111101111000111
11110111 1110101 10111101001
11111111 1111111 111111111111
